WWWWWWWWWWWWWWWWWWWW
W                  W
W WWWWWWWWWWW W WW W
W WPW    WW   W W  W
W W WWWW  EWW WEW WW
W        WWWW WWW WW
W WWWWWWWWW   EWW WW
W W            WW WW
WEW WW WWWWWWWWWW WW
WWW WW W          EW
W   EW WWWWWWWWWWWWW
WWWWW         EW   W
W   WW WWWWWWWWWWW W
W W                W
WWWWWWWWWWWWWWWWWWWW