WWWWWWWWWWWWWWWWWWWW
W                  W
W WWWWWWWWWWW W WW W
W WPWC   WWC  W W  W
W W WWWW  EWW WHW WW
W        WWWW WWW WW
W WWWWWWWWW   EWW WW
W W            WW WW
WHW WW WWWWWWWWWW WW
WWW WW W    C     EW
W C EW WWWWWWWWWWWWW
WWWWW     C   EWC  W
W   WW WWWWWWWWWWW W
WFW                W
WWWWWWWWWWWWWWWWWWWW