WWWWWWWWWWWWWWWWWWWW
W                  W
W WWWWWWWWWW  W WW W
W WPW    WWWW W W  W
W W WWWW  EWW WEW WW
W        WWW  WWW WW
W WWWWWWWWWW   WW WW
W W            WW WW
WEW WW WWWWWWWWWW WW
WWW WW W          EW
W   EW WWWWWWWWWWWWW
WWWWW         EW   W
W   WW WWWWWWWWWWW W
W W                W
WWWWWWWWWWWWWWWWWWWW